# Dungeon layout

# Width and height of the rooms in tiles
w 16
h 9

# Room Links, in the order of
# r UP DOWN LEFT RIGHT
# Put $ to represent no link
# The first room number is 0
# Room links. start with r

r $ 9 $ 1
e Knight 100 100
r $ $ 0 $
r $ $ $ $
r $ $ $ $
r $ $ $ $
r $ $ $ $
r $ $ $ $
r $ $ $ $
r $ $ $ $
r 0 $ $ 10
r $ $ 9 $
r $ $ $ $
r $ $ $ $
r $ $ $ $
r $ $ $ $
r $ $ $ $
r $ $ $ $
r $ $ $ $
r $ $ $ $
r $ $ $ $
r $ $ $ $
r $ $ $ $
r $ $ $ $
r $ $ $ $
r $ $ $ $
r $ $ $ $
r $ $ $ $
r $ $ $ $
r $ $ $ $
r $ $ $ $
r $ $ $ $
r $ $ $ $
r $ $ $ $
r $ $ $ $
r $ $ $ $
r $ $ $ $
r $ $ $ $
r $ $ $ $
r $ $ $ $
r $ $ $ $
r $ $ $ $
r $ $ $ $
r $ $ $ $
r $ $ $ $
r $ $ $ $
r $ $ $ $
r $ $ $ $
r $ $ $ $
r $ $ $ $
r $ $ $ $
r $ $ $ $
r $ $ $ $
r $ $ $ $
r $ $ $ $
r $ $ $ $
r $ $ $ $
r $ $ $ $
r $ $ $ $
r $ $ $ $
r $ $ $ $
r $ $ $ $
r $ $ $ $
r $ $ $ $
r $ $ $ $
r $ $ $ $
r $ $ $ $
r $ $ $ $
r $ $ $ $
r $ $ $ $
r $ $ $ $
r $ $ $ $
r $ $ $ $
r $ $ $ $
r $ $ $ $
r $ $ $ $
r $ $ $ $
r $ $ $ $
r $ $ $ $
r $ $ $ $
r $ $ $ $
r $ $ $ $
r $ $ $ $
r $ $ $ $
r $ $ $ $
r $ $ $ $
r $ $ $ $
r $ $ $ $
r $ $ $ $
r $ $ $ $
r $ $ $ $
r $ $ $ $
r $ $ $ $
r $ $ $ $
r $ $ $ $
r $ $ $ $
r $ $ $ $
r $ $ $ $
r $ $ $ $
r $ $ $ $
r $ $ $ $
r $ $ $ $
r $ $ $ $
r $ $ $ $
r $ $ $ $
r $ $ $ $
r $ $ $ $
r $ $ $ $
r $ $ $ $
r $ $ $ $
r $ $ $ $
r $ $ $ $
r $ $ $ $
r $ $ $ $
r $ $ $ $
r $ $ $ $
r $ $ $ $
r $ $ $ $
r $ $ $ $
r $ $ $ $
r $ $ $ $
r $ $ $ $
r $ $ $ $
r $ $ $ $
r $ $ $ $
r $ $ $ $
r $ $ $ $
r $ $ $ $
r $ $ $ $
r $ $ $ $
r $ $ $ $
r $ $ $ $
r $ $ $ $
r $ $ $ $
r $ $ $ $
r $ $ $ $
r $ $ $ $
r $ $ $ $
r $ $ $ $
r $ $ $ $
r $ $ $ $
r $ $ $ $
r $ $ $ $
r $ $ $ $
r $ $ $ $
