# Dungeon layout

# Width and height of the rooms in tiles
w 16
h 9

# Room Links, in the order of
# r UP DOWN LEFT RIGHT
# Put $ to represent no link
# The first room number is 0
# Room links. start with r

r $ 9 $ 1
r $ 10 0 2
r $ $ 1 $
r $ 12 $ $
r $ $ $ $
r $ $ $ $
r $ $ $ $
r $ $ $ $
r $ $ $ $
r 0 18 $ $
r 1 $ $ 11
r $ 20 10 12
r 3 $ 11 $
r $ $ $ $
r $ $ $ $
r $ $ $ $
r $ $ $ $
r $ $ $ $
r 9 27 $ 19
r $ $ 18 20
r 11 29 19 $
r $ $ $ $
r $ $ $ $
r $ $ $ $
r $ $ $ $
r $ $ $ $
r $ $ $ $
r 18 $ $ 28
r $ 37 27 $
r 20 $ $ 30
r $ $ 29 $
r $ $ $ $
r $ $ $ $
r $ $ $ $
r $ $ $ $
r $ $ $ $
r $ $ $ 37
r 28 46 36 $
r $ $ $ $
r $ $ $ $
r $ $ $ $
r $ $ $ $
r $ $ $ $
r $ $ $ $
r $ $ $ $
r $ $ $ $
r 37 $ $ $
r $ $ $ $
r $ $ $ $
r $ $ $ $
r $ $ $ $
r $ $ $ $
r $ $ $ $
r $ $ $ $
r $ $ $ $
r $ $ $ $
r $ $ $ $
r $ $ $ $
r $ $ $ $
r $ $ $ $
r $ $ $ $
r $ $ $ $
r $ $ $ $
r $ $ $ $
r $ $ $ $
r $ $ $ $
r $ $ $ $
r $ $ $ $
r $ $ $ $
r $ $ $ $
r $ $ $ $
r $ $ $ $
r $ $ $ $
r $ $ $ $
r $ $ $ $
r $ $ $ $
r $ $ $ $
r $ $ $ $
r $ $ $ $
r $ $ $ $
r $ $ $ $
r $ $ $ $
r $ $ $ $
r $ $ $ $
r $ $ $ $
r $ $ $ $
r $ $ $ $
r $ $ $ $
r $ $ $ $
r $ $ $ $
r $ $ $ $
r $ $ $ $
r $ $ $ $
r $ $ $ $
r $ $ $ $
r $ $ $ $
r $ $ $ $
r $ $ $ $
r $ $ $ $
r $ $ $ $
r $ $ $ $
r $ $ $ $
r $ $ $ $
r $ $ $ $
r $ $ $ $
r $ $ $ $
r $ $ $ $
r $ $ $ $
r $ $ $ $
r $ $ $ $
r $ $ $ $
r $ $ $ $
r $ $ $ $
r $ $ $ $
r $ $ $ $
r $ $ $ $
r $ $ $ $
r $ $ $ $
r $ $ $ $
r $ $ $ $
r $ $ $ $
r $ $ $ $
r $ $ $ $
r $ $ $ $
r $ $ $ $
r $ $ $ $
r $ $ $ $
r $ $ $ $
r $ $ $ $
r $ $ $ $
r $ $ $ $
r $ $ $ $
r $ $ $ $
r $ $ $ $
r $ $ $ $
r $ $ $ $
r $ $ $ $
r $ $ $ $
r $ $ $ $
r $ $ $ $
r $ $ $ $
r $ $ $ $
r $ $ $ $
r $ $ $ $
